###*###########
###*###########
###********####
##########*####
##########*####
#####*####*####
#***#******####
#*#*#*#########
#*#*#*###****##
#*********#####
#########*##*##
#*#######****##
#*#######*#####
#*************0
###############
