#########################
#########################
#########################
#########################
#########################
#########################
#########################
#########################
##############1##########
##############*##########
##############*##########
#############*******#####
##################**#####
##################**#####
##################**#####
#################***#####
#################*##***##
##########*****##*####*##
##########*##*****####*##
#############**#######*##
#############**######**##
#########*************###
#########*************###
###################***###
###################*0*###
