#########################
#########################
#########################
#########################
#########################
#########################
#########################
#########################
##############1##########
##############*##########
##############*##########
#############*******#####
##################**#####
##################**#####
##################x*#####
#################***#####
#################*##***##
##########*****##*####*##
#########**##*****####*##
#########*###**#######*##
#############*#######**##
#########*************###
#########*************###
###################***###
###################*0*###
